............................
............................
.p..........................
.###........................
............................
............................
.........##.................
............^^..............
...........####.............
.................k..........
................###......###
............................
...................##.......
............................
.....................E......
.....................#......
....^^^^^^^^^^^^^^^^^^^.....
#######################.....