............................
............................
............................
............................
............................
..p.........................
............................
............................
............................
...........................
.........................###
...............^............
.............#####..........
......####.................E.
####.....................###
............................
............................
#######################.....