............................
............................
............................
............................
............................
............................
............................
............................
............................
...........................E
.........................###
......................k.....
..........^.....^....##.....
.........###...###..........
.....##..................###
............................
p.k.........^^^.............
#######################.....