............................
............................
............................
............................
............................
..p.........................
............................
............................
............................
...........................E
.....................k...###
...............^....##......
.............#####..........
......####..................
####.....................###
............................
............................
#######################.....