............................
............................
............................
............................
............................
..p.........................
............................
............................
............................
...........................
.........................###
...............^............
.............#####....k.....
......####...........##...E.
####.....................###
............................
............kkkkkkkk........
#######################.....