............................
............................
............................
............................
........................E...
..................kk....#...
.................###........
............^^..............
...........####.............
.................k..........
................###......###
..........^^................
p........####..........##...
####........................
............................
............................
....^^^^^^..................
#######################.....