............................
............................
............................
........^^^.................
.....^#.^p^.#...............
........^.^...^.............
........^.^......^..........
^.#.....^.^........^........
^..^....^.^.....^.....^.....
^.......^.^................
^....^#.^.^..............###
^.......^E^.................
........^.^.....^....##.....
####...........###..........
.........................###
............................
^^^^^^^^^^^^^^^^^^^^^^^^^^^^
#######################.....

