............................
............................
............................
............................
............................
..p.........................
............................
............................
............................
...........................E
.........................###
...............^......#.....
.............#####..........
......####..................
####.....................###
............................
............................
#######################.....